 #   ###
 # #    
 # #####
 #######
   #   #
## # #  
 # # ###
 #   #/#
