 #   ###
 # #    
 # #####
 # #####
   #   #
## # #  
   # # #
 #    /#
